NO textures/bg305.xpm
SO textures/bg305.xpm
WE textures/bg305.xpm
EA textures/bg305.xpm
F 22,33,20
C 16,0,60
        1111111111111111111111111
        10000000001100000000000011
        1011000001100111111100011111
        10010000000000000000000000001
11111111101100000111000000N00000111111
100000000011001001110111111111111
11110111111111011100000010001
11110111111111011101010010001
11000000110101011100000010001
10000000000000001100000010001
10000000000000001101010010001
1100000111010101111101111000111
11110111 1110101 101111010001
11111111 1111111 111111111111
