NO textures/bg305.xpm
SO textures/bg305.xpm
WE textures/bg305.xpm
EA textures/bg305.xpm
F 22,33,53
C 16,0,20
        1111111111111111111111111
        1G00000000110000000000001
        10100000G11100011G0000001
        10010000000D0000000000001
        10110000011100000E0000001
        100D0000000D00000000000G1
111111111011000001110000000000001
1000000000P10010011111D1P11111111
11P10111111101P11100000000001
11110101111111011101010010001
1P000000110101011100000000001
1000GGG0000000001000000010001
10000000000000001101010010001
110000011101010111P101011000011
1111P111 1110101 101111010001
11111111 1111111 111111111111
